11111111111111111111111111111111
1.....E........................1
1..............................1
1..E............E..............1
1.......................E......1
1..............................1
1..............................1
1..............................1
1..............................1
1..............................1
1...........................E..1
1..............................1
1..............................1
1.............P.............E..1
1..............................1
1..........................E...1
1..............................1
1..............................1
1..............................1
1..............................1
1..............................1
1..............................1
1..............................1
11111111111111111111111111111111